####################################################################################################
#      #############################################################################################
#      #############################################################################################
#      v############################################################################################
#       ############################################################################################
###"################################################################################################
#  "#               ################################################################################
#" "                                                                                               #
#" "  ##                                                                                           #
#" "####            ################################################################################
#  ######          #################################################################################
########### ########################################################################################
########### ########################################################################################
########### ########################################################################################
########### ########################################################################################
########### ########################################################################################
########### ########################################################################################
########### ########################################################################################
########### ########################################################################################
########### ########################################################################################
########### ########################################################################################
########### ########################################################################################
########### ########################################################################################
###########  #######################################################################################
###########  #######################################################################################
############ #######################################################################################
############ #######################################################################################
############ #######################################################################################
############ #######################################################################################
############ #######################################################################################
############ #######################################################################################
############ #######################################################################################
############ #######################################################################################
############ #######################################################################################
############ #######################################################################################
############ #######################################################################################
############ #######################################################################################
############ #######################################################################################
############ #######################################################################################
############ #######################################################################################
############ #######################################################################################
############ #######################################################################################
############ #######################################################################################
############ #######################################################################################
############ #######################################################################################
############ #######################################################################################
############ #######################################################################################
############ #######################################################################################
############ #######################################################################################
############ #######################################################################################
############ #######################################################################################
############ #######################################################################################
############ #######################################################################################
############ #######################################################################################
############ #######################################################################################
############ #######################################################################################
############ #######################################################################################
############ #######################################################################################
############ #######################################################################################
############ #######################################################################################
############ #######################################################################################
############ #######################################################################################
############ #######################################################################################
############ #######################################################################################
############ #######################################################################################
############ #######################################################################################
############ #######################################################################################
############ #######################################################################################
############ #######################################################################################
############ #######################################################################################
############ #######################################################################################
############ #######################################################################################
############ #######################################################################################
############ #######################################################################################
############ #######################################################################################
############ #######################################################################################
############ #######################################################################################
############ #######################################################################################
############ #######################################################################################
############ #######################################################################################
############ #######################################################################################
############ #######################################################################################
############ #######################################################################################
############ #######################################################################################
############ #################                                                                     #
############ ################                                                                      #
############ ###############   #####################################################################
############ ##############   ######################################################################
############ #############   #######################################################################
############ ############   ########################################################################
############ ###########   #########################################################################
############ ##########   ##########################################################################
############ #########   ###########################################################################
############ ########   ############################################################################
############ #######   #############################################################################
############ ######   ##############################################################################
############         ###############################################################################
############        ################################################################################
############   #####################################################################################
####################################################################################################

